****************************************************************************************************
****************************************************************************************************
****************************************************************************************************
****************************************************************************************************
****************************************************************************************************
****************************************************************************************************
****************************************************************************************************
****************************************************************************************************
****************************************************************************************************
****************************************************************************************************
****************************************** *********************************************************
************************************  ***   ********************************************************
***********************************          *******************************************************
**********************************            ******************************************************
*********************************                   ************************************************
********************************                     ***********************************************
*********************************                     ****************      ************************
*********************************                      **************        ***********************
********************************         ***           ************      ***  **********************
*******************************     **   ***           ***********      ****   *********************
**************************  **      ********          ***********       ****    ********************
**************************          ** ****            *********        ***     ********************
*************************              ****             *********               ********************
************************      ***       ***                  ****        ***    ********************
***********************      *****       **                  ***        *****   ********************
***********************     *******       ***                           *****   ********************
***********************    ********       ***                           *****  *********************
***********************   *********                                      ***  **********************
**********************   **********                                          ***********************
*********************   **********                                          ************************
********************   ***********                                         *************************
****************       ***********                 ****                   **************************
***************         ***********               ******                 ***************************
*************            *********               *******                ****************************
************      ***     ***  **        **     ***  **                  ***************************
*************     ***      *            ***    ***                        **************************
*************      **                  ***    ***                          *************************
*************      **                  **    ***                          **************************
************       **                * *    ***                           **************************
******* ***        ****             **     ***                            **************************
******   *         *****           ***    **                     *         *************************
*****               ****          ***    **                     **          ************************
******            *********      ***    **                     ****               ******************
*******           ***   ***      **    **                      ***                 *****************
********                              **                        **                  ****************
*********                            **                        **                   ****************
**********                          **                        **                    ****************
***********                        **                        **                     ****************
************                      **                        **     *                ****************
*************                    **                        **     ***                ***************
**************                  **                        **     *****                *** **********
***************                 *                        **     *****                      *********
****************               ***                      **     *****   *                  **********
*****************                                      **     *****   ***                ***********
*****************                                     **       ***   *****              ************
******************                                   **    ***  *   *******            *************
*******************                                 **    *****    *********          **************
********************                               **     ****      *******          ***************
*********************                             **     ****        *****          ****************
********************1                            **     ****    *     ***          *****************
*******************                             **     ****    ***                ******************
******************                             **       **    *****              *******************
*****************                          *  **     **      *******            ********************
*****************                         *****     ****    *********         **********************
*****************                                  ****     ********         ***********************
******************                                ****       ******         ************************
*******************                              ****   **    ****         *************************
********************                            ****   ****               **************************
*********************                            **   ******             ***************************
**********************                               ********           ****************************
***********************                             *********          *****************************
************************                             *******          ******************************
*************************        ***                  *****          *******************************
**************************      *****                  ***          ********************************
***************************    ********                            *********************************
****************************************                          **********************************
*****************************************                        ***********************************
******************************************                      ************************************
*******************************************                    *************************************
********************************************                  **************************************
*********************************************                ***************************************
***********************************************             ****************************************
************************************************           *****************************************
*************************************************         ******************************************
**************************************************       *******************************************
***************************************************     ********************************************
****************************************************2  *********************************************
****************************************************************************************************
****************************************************************************************************
****************************************************************************************************
****************************************************************************************************
****************************************************************************************************
****************************************************************************************************
****************************************************************************************************
****************************************************************************************************
****************************************************************************************************
