****************************************************
****************************************************
****************************************************
****************************************************
****************************************************
****************************************************
****************************************************
************************** *************************
************************   *************************
***********************     ************************
******************* **      ************************
******************           ***********************
******************1           **********************
*****************       **    **********************
******************     ****    *********************
*******************    *****    ********************
*******************    ******    *******************
********************    *****     ******************
*********************    ****     ******************
**********************  ***        *****************
**********************   **      *******************
***********************           ******************
************************2         ******************
*************************         ******************
*************************          *****************
**************************          ****************
***************************  *      ****************
*******************************    *****************
******************************** *******************
****************************************************
****************************************************
****************************************************
****************************************************
****************************************************
****************************************************
****************************************************
****************************************************
****************************************************
