**************************2          ***********************
**************************             *********************
**************************              ********************
**************************               *******************
**************************               *** ***************
*************************                     **************
*************************                     **************
***************     *****                 *    *************
**************       ***            ***   **   *************
***************            ****    ****   **   *************
***************            ****  ******  ***   *************
***************            ***********   ***   *************
***************       *********************    *************
***************       ********************     *************
*************         ********************   ****    *******
*************        *********************   ***      ******
*************         *********************   **      ******
*************          ****************   **  **      ******
*************         *****************   **          ******
**************       ******* **********   ***         ******
***************     *******   *********               ******
****************    *******    ********               ******
*****************  *******      ******                ******
**************************  ***  **                   ******
*************************  ***** **                   ******
*************************  *****                      ******
************************1  ****                      *******
************************   ****                     ********
********    *   ********                            ********
********         ********                          *********
********            ****                          **********
********            **                            **********
*********                                        ***********
**********                                       ***********
***********                                     ************
************                                   *************
*************                                  *************
**************                                **************
***************                              ***************
*****************                            ***************
*******************                         ****************
*********************                       ****************
************************                   *****************
**************************                ******************
******************************           *******************
*********************************        *******************
************************************************************
************************************************************
