************************************  **********************
************************************      ******************
***********************************2      ******************
**********************************         *****************
*********************************            ***************
********************************              **************
********************************* **           *************
********************************* **            ************
********************************         **     ************
*************************** **           **      ***  ******
**************************               *        **   *****
**************************                             *****
*************************                               ****
************************                                ****
*********************        *                         *****
***********************     ***                       ******
************************   *****                     *******
************************  *******                   ********
***********************   ********                 *********
*********************      ********               **********
********************        *******              ***********
*******************          *****              ************
******************            ***              *************
*****************                             **************
****************                             ***************
***************  ***                        ****************
****** ******** *****                      *****************
*****   ******  ******                    ******************
****      ***    ******                  *******************
***1       *      *****                 ********************
**                 ***                 *********************
**                                    **********************
***                                  ***********************
****                                ************************
*****                              *************************
******                            **************************
*******                          ***************************
********                        ****************************
*********                      *****************************
**********                    ******************************
***********                 ********************************
************               *********************************
*************             **********************************
**************           ***********************************
***************         ************************************
****************       *************************************
************************************************************
************************************************************
