**************************        ******************
*************************        *******************
************************        ********************
***********************        *********************
**********************        ******** * ***********
**********************        *******     **********
**********************         *****       *********
********************            ***         ********
*******************                          *******
******************                           *******
****************        ***                 ********
***************         *****              *********
**************           *****            **********
*************      *       ***           ***********
***********      **** **** **           ************
**********        ********             *************
************2     ********            **************
*************      ******            ***************
**************      ******          ****************
**************       *****         *****************
*************         ***         ******************
*******                          *******************
********                        ********************
*********                      *********************
**********                    **********************
***********                  ***********************
************                ************************
*************              *************************
**************            **************************
***************          ***************************
****************        ****************************
*****************      *****************************
******************    ******************************
*******************1 *******************************
****************************************************
****************************************************
****************************************************
****************************************************
