***************************     ********************
****************************    *** ****************
****************************    **     *************
**************************             *************
*************************              *************
************************               ** **********
***********************                    *********
**********************                      ********
********************     ***                 *******
**********  *******     *****                 ******
*********    **        *******                 *****
********     *        *******                 ******
*******      **      *******                 *******
******        *     *******                 ********
*******2      **   *******                 *********
*******        *  *******                 **********
********       *   ****                  ***********
********       **   **                  ************
*********       *   *                  *************
*********       *                     **************
**********                           ***************
**********                          ****************
***********                        *****************
***********                       ******************
**********                       *******************
*********                       ********************
********1                      *********************
********                      **********************
*********                    ***********************
**********                  ************************
***********                *************************
************              **************************
*************            ***************************
**************          ****************************
***************        *****************************
****************      ******************************
*****************    *******************************
****************************************************
