*******************************     *****  *****************
*******************************      *****  ****************
*******************************      *****   ***************
*********************************    ****       ************
*********************************             *  ***********
*******************************              ***  **********
******************************              ***    *********
*****************************              *****    ********
**************************  **             ********  *******
*********************** ** ***            *********   ******
***********************                   *** **       *****
**********************             ***                  ****
********************               ***                  ****
*******************                                    *****
******************     **                             ******
*****************     ****  **                       *******
*****************    *********                      ********
******* ********   *********                       *********
******   ******   ***********  **                 **********
*****     ****     **************                ***********
****      ***      ************                 ************
****       *        *  *********               *************
*****      *            *********             **************
*****      **           **********           ***************
******1     *           ********            ****************
******      **         ********            *****************
******       *        ********            ******************
*****        **      **********          *******************
****          *     **********          ********************
****          *    ********            *********************
*****             **********          **********************
******2          ******** *          ***********************
*******         ********            ************************
********       ********            *************************
*********     *********           **************************
**********     *******           ***************************
***********     ****            ****************************
************     **            *****************************
*************                 ******************************
**************              ********************************
***************            *********************************
****************          **********************************
*****************        ***********************************
*******************     ************************************
********************   *************************************
************************************************************
************************************************************
************************************************************
