***********************  *********     ***   ***********
**********************   *********      *   ************
*********************      ******          *************
********************      ******           *************
*********************     *****             ************
**********************     ***               ***********
***********************                      ***********
************************                 ***************
*************************                ***************
*************************                *     *********
***************  ******                  *        ******
************     ******                       ***  *****
***********      ****                         ****  ****
**********       ****                   **    ****  ****
**********                              **   ***** *****
***********                             **   ***********
*************                           **    **********
**************                          **      ********
**** **********                        **       ********
***   *********                        ***     *********
**     ******                           **    **********
**     *****                    **       *   ***********
**      **                      **          ************
**                             ****        *************
***                          ********     **************
****                         ********    ***************
*****1                       *******    ****************
******                         ****   ******************
*******                              *******************
********               **           ********************
*********              ***         *********************
**********            ****        **********************
***********         ******       ***********************
************        *******     ************************
*************         *****    *************************
**************         ****   **************************
***************              ***************************
****************            ****************************
*****************2         *****************************
******************        ******************************
*******************      *******************************
********************    ********************************
********************************************************
