*****************************1     ** **************
****************************          **************
***************************           **************
**************************           ***************
*************************      *       *************
******************* ****      ****        **********
*******************       ** ******      ***********
*******************      ***  *****      ***********
********************     ***    ****     ***********
*******************          **  ***      **********
*****************           ***   *        *********
*****************      ***  ***             ********
****************       ****     **           *******
***************         ****   ***            ******
*************            ****  ***             *****
***********               ****  *              *****
***********                **                 ******
***********                                  *******
**********      **                          ********
*********       ***                        *********
*****           ***                       **********
****2         *  **                      ***********
***          **   *                     ************
**           ***                       *************
**            **                      **************
***           **                     ***************
****                                ****************
*****                              *****************
******                            ******************
*******                          *******************
********                        ********************
*********                      *********************
**********                    **********************
***********                  ***********************
************                ************************
*************              *************************
**************            **************************
****************************************************
