***********************    *************************
***********************    *************************
***********************2   *************************
****************  *****    *************************
***************    ***     *************************
***************     *       ************************
**************1             ************************
*************                       ****************
*************                        ***************
************              *****         ************
************              ******         ***********
************    **            ***         **********
***********    **              ***         *********
**********     **                **        *********
********      **                  ***       ********
********      **                   **       ********
*******       **                    **        ******
*******      **                      *        ******
*******      **         ****         *        ******
*******      **        ******        **       ******
*******      ***       ******        **       ******
*******      ***       ******        **        *****
*******      ***        ****         **        *****
*******      ***                    ***         ****
*******       ***                   ***         ****
*******       ***                  ****         ****
*******        **                  ***          ****
*******        ***                ***           ****
*******         ***              ***            ****
*******          ***            ***             ****
*******          *****        ****             *****
*******           ***************              *****
*******             ************               *****
********                                      ******
*********                                    *******
**********                                  ********
************                             ***********
***************                        *************
****************                   *****************
*******************             ********************
****************************************************
****************************************************
****************************************************
