**************************        ******************
**************************       *******************
************************        ********************
************************         *******************
***********************       **  ***** ************
**********************        **   ***   ***********
**********************            ***       ********
**********************           ***         *******
*********************             **          ******
********************                          ******
*******************       **                 *******
*************** **       ****               ********
***************                            *********
************ *       *** ***              **********
************1        *** ***             ***********
***********               *             ************
*********                   *          *************
********                  ***         **************
*******                   **         ***************
******       **                     ****************
*******     ***                    *****************
********   *****                  ******************
*********2*******                *******************
******************              ********************
*******************            *********************
*******************           **********************
*******************          ***********************
******************          ************************
*****************          *************************
****************          **************************
*****************        ***************************
******************      ****************************
*******************    *****************************
****************************************************
****************************************************
****************************************************
****************************************************
****************************************************
