**************************        ******************
**************************1      *******************
************************         *******************
************************         *******************
***********************       **  ***** ************
**********************        **   **    ***********
**********************            **        ********
**********************           ***         *******
*********************             **          ******
********************                          ******
*******************       **                 *******
*************** *        ****               ********
*******  ******                            *********
*******              *** ***              **********
*******              *** ***             ***********
********  ***             *             ************
***************             *          *************
***************           ***         **************
***************                      ***************
***************                     ****************
***************                    *****************
****************                  ******************
*****************                *******************
******************              ********************
*******************            *********************
*******************           **********************
*******************          ***********************
******************          ************************
*****************          *************************
****************2         **************************
*****************        ***************************
******************      ****************************
*******************    *****************************
****************************************************
****************************************************
****************************************************
****************************************************
****************************************************
