************************************************      ******
***********************************************        *****
**********************************************         *****
**********************************************         *****
********************************************           *****
******************************************           *******
*****************************************2           *******
****************************************1            *******
***************************************              *******
**************************************               *******
************************************                 *******
**********************************                   *******
********************************                    ********
******************************                       *******
****************************                        ********
*************************                           ********
***********************                             ********
*********************                                *******
*******************                                  *******
*******************                 ****             *******
********************               ******            *******
*********************              ******           ********
*************************          ******           ********
**************************         ******          *********
***************************         ****           *********
****************************                       *********
******************************                     *********
******************************                     *********
*****************************                      *********
*****************************                     **********
****************************                       *********
****************************            *          *********
*****************************          ***         *********
*******************************       **** **      *********
*********************************     *******      *********
***********************************  *********     *********
************************************************   *********
************************************************************
************************************************************
************************************************************
************************************************************
************************************************************
************************************************************
************************************************************
************************************************************
************************************************************
************************************************************
************************************************************
