**************************************************
**************************************************
**************************************************
**************************************************
**************************************************
**************************************************
*************************** **********************
*************************    *********************
************************1     ********************
***********************  *     *******************
**********************  ***   ********************
*********************  ******     ****************
********************  ********     ***************
*******************    ********      *************
******************   *   ******       ************
*****************   ***   ****         ***********
*****************   *****  **         ************
****************     *****           *************
***************       ****          **************
**************         **          ***************
************                      ****************
***********                      *****************
**********                      ******************
**********                     *******************
*********                      *******************
**********2                   ********************
***********                  *********************
************                **********************
*************              ***********************
**************            ************************
***************          *************************
****************        **************************
*****************      ***************************
**************************************************
