*****************1   **********       ******************
****************    ********           *****************
*****************   *****                ***************
******************  ***                   **************
******************    ***                 **************
*************  **                          *************
***********                                *************
**********                                  ************
*********2                                     *********
*********                                      *********
*********                  *********           *********
*********                ************          *********
**********            ****************         *********
************       *******************            ******
*************     ********************            ******
*************     *********************    ***    ******
*************     *********************    *****  ******
**********  **    **********************  ******* ******
*********    *   ***********************  *****   ******
*********        ***********************     **   ******
***              ***********************           *****
***              ***********************            ****
***               ********************         ***     *
***                *******************         ***     *
***    **           *****************          ***     *
****   **            *****************                 *
****                  ****************                 *
****                   ***************                 *
****                      ***********                  *
****                        ********                   *
****                                                   *
*****                                                  *
*****                                                  *
******                                                 *
*******                            **                  *
********           **              **                  *
*********          **                                  *
**********                                            **
***********                                          ***
************                                      ******
*************                                    *******
***************                                *********
********************************************************
