************       ************    *****************
*************       ** ********     ****************
**************          * ***        ***************
*************1 *                       *************
************  **                        ************
****************                         ***********
***************                            *********
************              *      *****      ********
*************         ********   ******      *******
**************       *********   ******     ********
**************       *********   ******    *********
*************         ********   *****    **********
**************2       ******             ***********
***************                         ************
****************                       *************
*****************                     **************
********** ******                     **************
*********   ****                     ***************
**********   **                      ***************
***********         **              ****************
************       ****            ***** ***********
***********         **              * **   *********
***********         **         **           ********
**********                    ****           *******
*********                    ******           ******
*********                    ******            *****
**********                    ******             ***
***********                    ******            ***
************               **   *****           ****
*************             ****   ***           *****
**************           ******               ******
***************         ********             *******
****************       **********           ********
*****************     ************         *********
******************   **************       **********
******************* ****************     ***********
*************************************   ************
****************************************************
