**************         **********          *************
*************         **********    *       ************
************         ************  **      *************
***********         *********************     **********
**********          ******    ***********      *********
*********          ****        *********        ********
*********          **                            *******
*********                                        *******
*********                                      *********
*******                         ****          **********
*******2                   **********         **********
*******                 **************        **********
*******              *****************        **********
*******             *******************       **********
*******            ********************       **********
*******       **   ********************        *********
*******   ******   *********************       *********
*******  ******** **********************       *********
*******    ****** **********************            ****
******      ***** **********************            ****
******       **** **********************            ****
******        *** **********************            ****
******             ********************             ****
*****              ********************             ****
*****      ***      ******************              ****
*****      ****      *****************              ****
*****1      ***      *****************              ****
******                 ****************             ****
*******                 **************              ****
********                   *********                ****
*********                     **                   *****
**********                                        ******
***********                                    * *******
*************                                 **********
***************                             ************
****************                          **************
*****************                       ****************
*******************                    *****************
**********************               *******************
********************************************************
********************************************************
********************************************************
********************************************************
