**************************** ****  *****************
***************************   **     ***************
**************************            **************
**************************             *************
*************************1      **      ************
***********************        *****     ***********
**********************         *******    **********
*********************          *******   ***********
**********************         ****     ************
***********************         *      *************
************************               *************
*****************  ******              *************
****************    *****               ************
***************      ****                ***********
****************2    ***                  **********
*****************                        ***********
******************                      ************
*******************                    *************
************ ******                   **************
******** **   *****                  ***************
*******        ***                  ****************
******                             *****************
******               **           ******************
*******             ***          *******************
********           **           ********************
*********         **           *********************
**********       **           **********************
***********     **           ***********************
************   **           ************************
************* **           *************************
***************           **************************
***************          ***************************
****************        ****************************
*****************      *****************************
******************    ******************************
*******************  *******************************
****************************************************
****************************************************
