***************************        *****************
*************************           ****************
************************             ** ************
***********************                  ***********
**********************          **       ***********
*********************         ****      ************
**********************      ******     *************
**********************      ******     *************
*********************        ******     ************
********************          *****      ***********
*******************              **       **********
******************                         *********
************* **                            ********
*********                                  *********
**********        *                       **********
************     ***                     ***********
**************  *****                   ************
**********************                 *************
***********************               **************
************************             ***************
*************************           ****************
********** ***************         *****************
*********   **************        ******************
*********    ************        *******************
**********1   **********        ********************
***********    ********        *********************
************    ******        **********************
*************    ****        ***********************
**************2   **        ************************
***************            *************************
****************          **************************
*****************        ***************************
******************      ****************************
*******************    *****************************
****************************************************
****************************************************
****************************************************
****************************************************
