*****************************              *********************
****************************    **        ** *******************
***************************      **      **   ******************
*************************         **    **     *****************
*************************          **  **       ****************
*************************           ****         ***************
**************************           **            *************
***************************2                        ***** ******
****************************                               *****
*****************************                               ****
******************************                               ***
************************** ****                               **
******************* *****   ****                  **           *
******************   ***     ****               *****          *
******************            ****            ********         *
*******************            **             *********       **
********************                           *********     ***
********************                *           *********   ****
************  ****                 ***           ********* *****
***********    **            *     ****           **************
***********                 **      ****           *************
************               ****      ****           ************
***** *******             ******      ****           ***********
****   ******            *******       ****           **********
***     ****            ********         ***         ***********
***      **             *******         ******      ************
****                   *******         ********    *************
*****               *  ******         **********  **************
******             ***  **            **************************
*******           *****               **************************
********         *******               *************************
*********       ********          **    ************************
**********       ******          ****    ***********************
***********       ****          ******    **********************
************       **          ********    *********************
*************                   ********  **********************
**************                   *******************************
***************1           **     ******************************
****************          ****     *****************************
*****************        ******     ****************************
******************      ********     ***************************
*******************      ********   ****************************
********************      ******** *****************************
*********************      *************************************
**********************      ************************************
***********************      ***********************************
************************      **********************************
****************************************************************
