***************    ***       ********      *************
**************    ****        ******       *************
*************     ***          ****        *************
************       *            **      ****************
**********                             *****************
*********                              *****************
********1                ****           **    **********
*********                *****               ***********
**********              *******             ************
***********             ********           *************
*************    *      *********        ***************
***************  **      *********      ****************
***************   **      *********    *****************
****************  ***      ********     ****************
****************  ****      ******       ***************
***************** *****      ****         **************
************************     ***           *************
************************                    ************
************************                     ***********
*************** ********                      **********
************                                  **********
**********                           *       ***********
********                            ***     ************
*******    **                       ****   *************
******    **                         **** **************
******2                  *            ******************
******                  ***            *****************
******                 *****           *****************
*******               *******         ******************
********             *********       *******************
*********           ************    ********************
**********         ************** **********************
***********       **************************************
************    ****************************************
************** *****************************************
********************************************************
********************************************************
********************************************************
