*************************   * **************************
************************        ************************
***********************          ***********************
**********************          ************************
**********************          ************************
*********************            ***********************
********************  **         ***********************
******************** ***        ************************
*******************              *  ********************
******************                    ******************
*****************                      ** **************
*****************                      **  *** *********
****************2                      **   *   ********
******************                     **         ******
*************** **             *                  ******
**************  **            ***                 ******
*************                   ***               ******
************                     **              *******
************                                    ********
***********                                 **  ********
**********                                  ************
*********  **                                ***********
********* ***                                ***********
********  **                                 ***********
*******                                      ***********
******                                      ************
********1                                  *************
*********                              **  *************
***********                            *****************
************                            ****************
**************                          ****************
***************                         ****************
****************                       *****************
******************                     *****************
*******************                   ******************
*********************            **  *******************
***********************          ***********************
********************************************************
