******************************    ******************
*****************************        ***************
**************************           ***************
**************************             *************
**************************              ************
************************                  **********
***********************                    *********
**********************1                     ********
***************** ****                       *******
****************   ***  ****                  ******
***************         *****                 ******
**************         *******                ******
*************         *********              *******
*************        **********             ********
**************       *********             *********
***************      ********             **********
**************       ********            ***********
*************        ******             ************
************                           *************
***********                           **************
****** ***                           ***************
******  *                           ****************
******                             *****************
******2                           ******************
******                           *******************
******                          ********************
*******                        *********************
********                      **********************
*********                    ***********************
**********                  ************************
***********                *************************
************              **************************
*************            ***************************
**************          ****************************
***************        *****************************
****************      ******************************
*****************    *******************************
****************************************************
