****************************   *********    ********************
***************************    ********      *******************
**************************      *******       ******************
*************************     ********         *****************
************************      ******            ****************
*************************     ******             ***************
**************************     *  **              **************
********************* *****                         ************
********************   *****                        ************
*******************      ****                      *************
******************        ****                    **************
*****************   **     ****                  ***************
****************   ****     ****                ****************
***************1  ******     ****              **********  *****
**************    *******     ****            *******        ***
************     ********      **              *****         ***
***********    *  *********                     ***          ***
**********    **   ********         *            *          ****
*********    ****   *******        ***                     *****
********    ******   ******        ****                   ******
*******    ********    ***          ****                 *******
******     *********                 ****               ********
*****       *********                 ****             *********
****         ********         ****     ****           **********
***           *******        ******      ***         ***********
***            ******        *******      ****      ************
****                         *********     ****    *************
*****                        **********     ****  **************
******                  ***    *******       *******************
*******                *****    *****         ******************
********               *******   ***           *****************
*********              ********   *           ******************
**********             *********             *******************
***********             ********            ********************
************             *******           *********************
*************             *****           **********************
**************             **            ***********************
***************                         ************************
****************                       *************************
*****************                     **************************
******************                   ***************************
*******************                 ****************************
********************               *****************************
*********************             ******************************
**********************2          *******************************
***********************         ********************************
************************       *********************************
****************************************************************
