**********      **        *******                 **********
*********      ***    *      ****                  *********
********      ***     *                             ********
*******1     ***                  **     *           *******
******      ***                  ****    *           *******
******2      *                     ****               ******
*****                               ****         *    ******
*****                                *          ***    *****
****                                     *       ***    ****
****                      **            *****     *** * ****
****                     ******        *******     **** ****
****                      ******           **      *********
****                        **                      ********
****       **                                       ********
****        *                                        *******
****                  ***                             ******
**** **         **   *****     *                        ****
********       ****    *****  **                        ****
*********      ****      ***                    *       ****
**** ***      *****       *                     **      ****
****  **        * **                                    ****
****                                  **                ****
****                                 ***         **     ****
****                                 ****       ****    ****
*****                               ****        ****    ****
*****                                  *       *****    ****
******     **                                    ****   ****
******    ****                                          ****
*******  ******                                        *****
*******    ****                                       ******
********    **                              ****      ******
********                                    ****     *******
*********         *                        *****    ********
*********         **             **                *********
**********                      ****              **********
************                    ****    **       ***********
**************                  *****          *************
************************************************************
