*************                               **********  
************                                **********  
***********                                 *********** 
**********                                   ***********
*********                                     **********
********                                       *********
********                                        ********
********                                         ****** 
*******                                          ****** 
*******                                          *******
*******                                          *******
*******                                          *******
*******                                          *******
*******1                  ***                    *******
*******                   ***                    *******
*******                   ***                    *******
*******                                          *******
*******                                          *******
*******                                          *******
*******                                          *******
*******                                          *******
*******                                          *******
*******                                          *******
*******                                          *******
*******                                          *******
********                                          ******
*********                                        *******
**********                                      ********
***********                                    *********
************2                                 **********
*************                                ***********
**************                              ************
****************                           *************
******************                       ***************
********************                   *****************
***********************             ********************
********************************************************
********************************************************
********************************************************
********************************************************
********************************************************
********************************************************
********************************************************
