****************************      **********************
***************************      ***** *****************
**************************   **  *****    **************
**************************  ***  *****      ************
*************************  ****  *****  **  ************
************************  ***      ***  ****************
************************  ***           ****************
*********************                     **************
********************   *                   *************
*******************   ***                   ** *********
******************** *****                       *******
******************** ******                        *****
*******************  *******                        ****
*****************    *****                          ****
*******************    **                          *****
********************                              ******
********************      *                      *******
*******************      ***                    ********
********* ***  ***     *****                   *********
********  ***   *      ******                 **********
*******    **          *****                 ***********
*****       *  **        *                  ************
****          ****                         *************
***           *****                       **************
**             ****                      ***************
*               ***                     ****************
**               *                     *****************
***                                   ******************
****                                 *******************
*****                               ********************
******                             *********************
*******                           **********************
********2                        ***********************
*********                       ************************
**********                     *************************
***********                   **************************
************                 ***************************
*************               ****************************
**************             *****************************
***************           ******************************
****************         *******************************
*****************1      ********************************
********************************************************
