******************************    ******************
*****************************        ***************
**************************           ***************
**************************             *************
**************************              ************
************************                  **********
***********************                    *********
**********************                      ********
***************** ****                       *******
****************   ***  ****                  ******
***************         *****                 ******
**************         *******                ******
*************         *********              *******
*************2       **********             ********
**************       *********             *********
***************      ********             **********
**************       ********            ***********
*************        ******             ************
************                           *************
***********1                          **************
****** ***                           ***************
******  *                           ****************
******                             *****************
******                            ******************
******                           *******************
******                          ********************
*******                        *********************
********                      **********************
*********                    ***********************
**********                  ************************
***********                *************************
************              **************************
*************            ***************************
**************          ****************************
***************        *****************************
****************      ******************************
*****************    *******************************
****************************************************
