*****************************              *********************
****************************    **        ** *******************
***************************      **      **   ******************
*************************         **    **     *****************
*************************          **  **       ****************
*************************           ****         ***************
**************************2          **            *************
***************************                         ************
****************************                         ***********
*****************************                         **********
******************************                         *********
************************** ****                         ********
******************* *****   ****                         *******
******************   ***     ****                         ******
******************            ****                         *****
*******************            **                           ****
********************                                         ***
********************                *                       ****
************  ****                 ***                     *****
***********    **            *     ****                   ******
***********                 **      ****                 *******
************               ****      ****               ********
***** *******             ******      ****             *********
****   ******            *******       ****           **********
***     ****            ********         ***         ***********
***      **             *******         ******      ************
****                   *******         ********    *************
*****               *  ******         **********  **************
******             ***  **            **************************
*******           *****               **************************
********         *******               *************************
*********       ********          **    ************************
**********       ******          ****    ***********************
***********       ****          ******    **********************
************       **          ********    *********************
*************                   ********  **********************
**************                   *******************************
***************            **     ******************************
****************          ****     *****************************
*****************        ******     ****************************
******************      ********     ***************************
*******************      ********   ****************************
********************      ******** *****************************
*********************      *************************************
**********************      ************************************
***********************      ***********************************
************************1     **********************************
****************************************************************
