*********************************   *****  *****************
********************************     *****  ****************
*******************************      *****   ***************
*********************************    ****       ************
*********************************             *  ***********
*******************************              ***  **********
******************************              ***    *********
*****************************              *****    ********
**************************2 **             ********  *******
*********************** ** ***            *********   ******
***********************                   *** **       *****
**********************             ***                  ****
********************               ***                  ****
*******************                                    *****
******************     **                             ******
*****************     ****  **                       *******
*****************    *********                      ********
****************   *********                       *********
***************   ***********  **                 **********
**************     **************                ***********
*************      ************                 ************
***********         *  *********               *************
***********             *********             **************
************            **********           ***************
***********             ********            ****************
******* **             ********            *****************
******                ********            ******************
*****                **********          *******************
****                **********          ********************
****               ********            *********************
*****             **********          **********************
******1          ******** *          ***********************
*******         ********            ************************
********       ********            *************************
*********     *********           **************************
**********     *******           ***************************
***********     ****            ****************************
************     **            *****************************
*************                 ******************************
**************              ********************************
***************            *********************************
****************          **********************************
*****************        ***********************************
*******************     ************************************
********************   *************************************
************************************************************
************************************************************
************************************************************
