***************************        *****************
*************************           ****************
************************             ** ************
***********************                  ***********
**********************          **       ***********
*********************         ****      ************
**********************      ******     *************
**********************      ******     *************
*********************        ******     ************
********************          *****      ***********
*******************              **       **********
******************                         *********
************* **                            ********
************                               *********
************      *                       **********
**********       ***                     ***********
*********       *****                   ************
********       *******                 *************
*******       *********               **************
******       ***********             ***************
******      *************           ****************
*******    ***************         *****************
********    **************        ******************
*********    ************        *******************
**********    **********        ********************
***********    ********        *********************
************    ******        **********************
*************    ****        ***********************
**************    **        ************************
***************1           *************************
****************          **************************
*****************2       ***************************
******************      ****************************
*******************    *****************************
****************************************************
****************************************************
****************************************************
****************************************************
